####################
####    ####       #
#### ## #####  ### #
#### ##  #  ## ### #
#### #A#B##    ### #
#### # # ######### #
#### # # ######### #
#### #             #
####################