###### ########
###### ###  ###
###### #### ###
##B#   #### ###
## ###      ###
##      ### ###
####### ### ###
               
####### #######
####### #######
#######  ######
###### # ######
###      ######
##  ## ########
#A ### ########