 #####
      
 ## ##
 ##B##
 #  ##
 # ###
A  ###